%%%%%%%
%    S%
% %%% %
%     %
%%%%% %
%G    %
%%%%%%%
